30;12
XXXXXXXXXXXXXXXXXXXXXXXXXXXXXX
X X    X  X     X   X     X XX
X X X  X XX XXX X  XX XXX X  X
X XXXX X    X   XX    X   XX X
X X  X XX X XXX X X X XXX X  X
X         X  X      X  X    XX
X X    X  X     X   X     X XX
X X X  X XX XXX X  XX XXX X  X
X XXXX X    X   XX    X   XX X
X X  X XX X XXX X X X XXX X  X
X         X  X      X  X    XX
XXXXXXXXXXXXXXXXXXXXXXXXXXXXXX